8 12
############
#1_________#
#_#######__#
#_______#__#
#______ #__#
#_#######__#
#_________2#
############