8 12
############
#P_________#
#_#######_##
#____V__#_##
#_#####_#_##
#_#####_#_##
#__________#
############